1 0
19 11 19 12 19 13 19 14 19 15
20 15 21 15 22 15 23 15 
25 11 25 12 25 13 25 14 25 15
26 11 26 13 26 15 27 11 27 13 27 15 
28 11 28 15 29 11 29 15 
31 11 31 12 32 13 33 14 33 15 
34 15 35 14 35 15 36 13 37 11 37 12
39 11 39 12 39 13 39 14 39 15 
40 11 40 13 40 15 41 11 41 13 41 15
42 11 42 15 43 11 43 15
45 11 45 12 45 13 45 14 45 15 
46 15 47 15 48 15 49 15 
52 11 52 15 53 11 53 15 
54 11 54 12 54 13 54 14 54 15
55 11 55 12 55 13 55 14 55 15 
56 15 57 15
2 0
19 11 19 12 19 13 19 14 19 15
20 15 21 15 22 15 23 15 
25 11 25 12 25 13 25 14 25 15
26 11 26 13 26 15 27 11 27 13 27 15 
28 11 28 15 29 11 29 15 
31 11 31 12 32 13 33 14 33 15 
34 15 35 14 35 15 36 13 37 11 37 12
39 11 39 12 39 13 39 14 39 15 
40 11 40 13 40 15 41 11 41 13 41 15
42 11 42 15 43 11 43 15
45 11 45 12 45 13 45 14 45 15 
46 15 47 15 48 15 49 15 
52 11 52 13 52 14 52 15 
53 11 53 13 53 15 54 11 54 13 54 15
55 11 55 13 55 15 56 11 56 13 56 15
57 11 57 12 57 13 57 15
3 0
19 11 19 12 19 13 19 14 19 15
20 15 21 15 22 15 23 15 
25 11 25 12 25 13 25 14 25 15
26 11 26 13 26 15 27 11 27 13 27 15 
28 11 28 15 29 11 29 15 
31 11 31 12 32 13 33 14 33 15 
34 15 35 14 35 15 36 13 37 11 37 12
39 11 39 12 39 13 39 14 39 15 
40 11 40 13 40 15 41 11 41 13 41 15
42 11 42 15 43 11 43 15
45 11 45 12 45 13 45 14 45 15 
46 15 47 15 48 15 49 15 
52 11 52 15 53 11 53 15 
54 11 54 13 54 15
55 11 55 13 55 15 56 11 56 13 56 15
57 11 57 12 57 13 57 14 57 15
4 0
19 11 19 12 19 13 19 14 19 15
20 15 21 15 22 15 23 15 
25 11 25 12 25 13 25 14 25 15
26 11 26 13 26 15 27 11 27 13 27 15 
28 11 28 15 29 11 29 15 
31 11 31 12 32 13 33 14 33 15 
34 15 35 14 35 15 36 13 37 11 37 12
39 11 39 12 39 13 39 14 39 15 
40 11 40 13 40 15 41 11 41 13 41 15
42 11 42 15 43 11 43 15
45 11 45 12 45 13 45 14 45 15 
46 15 47 15 48 15 49 15 
52 11 52 12 52 13 53 13  
54 13 55 13 56 13 
57 11 57 12 57 13 57 14 57 15
5 0
19 11 19 12 19 13 19 14 19 15
20 15 21 15 22 15 23 15 
25 11 25 12 25 13 25 14 25 15
26 11 26 13 26 15 27 11 27 13 27 15 
28 11 28 15 29 11 29 15 
31 11 31 12 32 13 33 14 33 15 
34 15 35 14 35 15 36 13 37 11 37 12
39 11 39 12 39 13 39 14 39 15 
40 11 40 13 40 15 41 11 41 13 41 15
42 11 42 15 43 11 43 15
45 11 45 12 45 13 45 14 45 15 
46 15 47 15 48 15 49 15 
52 11 52 12 52 13 52 15 53 11 53 13 53 15  
54 11 54 13 54 15 55 11 55 13 55 15
56 11 56 13 56 15 57 11 57 13 57 14 57 15
6 0
19 11 19 12 19 13 19 14 19 15
20 15 21 15 22 15 23 15 
25 11 25 12 25 13 25 14 25 15
26 11 26 13 26 15 27 11 27 13 27 15 
28 11 28 15 29 11 29 15 
31 11 31 12 32 13 33 14 33 15 
34 15 35 14 35 15 36 13 37 11 37 12
39 11 39 12 39 13 39 14 39 15 
40 11 40 13 40 15 41 11 41 13 41 15
42 11 42 15 43 11 43 15
45 11 45 12 45 13 45 14 45 15 
46 15 47 15 48 15 49 15 
52 11 52 12 52 13 52 14 52 15 53 11 53 13 53 15  
54 11 54 13 54 15 55 11 55 13 55 15
56 11 56 13 56 15 57 11 57 13 57 14 57 15
7 0
19 11 19 12 19 13 19 14 19 15
20 15 21 15 22 15 23 15 
25 11 25 12 25 13 25 14 25 15
26 11 26 13 26 15 27 11 27 13 27 15 
28 11 28 15 29 11 29 15 
31 11 31 12 32 13 33 14 33 15 
34 15 35 14 35 15 36 13 37 11 37 12
39 11 39 12 39 13 39 14 39 15 
40 11 40 13 40 15 41 11 41 13 41 15
42 11 42 15 43 11 43 15
45 11 45 12 45 13 45 14 45 15 
46 15 47 15 48 15 49 15 
52 11 53 11 54 11 55 11 
56 11 56 12 56 13 56 14 56 15 
57 11 57 12 57 13 57 14 57 15
8 0
19 11 19 12 19 13 19 14 19 15
20 15 21 15 22 15 23 15 
25 11 25 12 25 13 25 14 25 15
26 11 26 13 26 15 27 11 27 13 27 15 
28 11 28 15 29 11 29 15 
31 11 31 12 32 13 33 14 33 15 
34 15 35 14 35 15 36 13 37 11 37 12
39 11 39 12 39 13 39 14 39 15 
40 11 40 13 40 15 41 11 41 13 41 15
42 11 42 15 43 11 43 15
45 11 45 12 45 13 45 14 45 15 
46 15 47 15 48 15 49 15 
52 11 52 12 52 13 52 14 52 15 
53 11 53 13 53 15  
54 11 54 13 54 15 
55 11 55 13 55 15 
56 11 56 13 56 15 
57 11 57 12 57 13 57 14 57 15
9 0
19 11 19 12 19 13 19 14 19 15
20 15 21 15 22 15 23 15 
25 11 25 12 25 13 25 14 25 15
26 11 26 13 26 15 27 11 27 13 27 15 
28 11 28 15 29 11 29 15 
31 11 31 12 32 13 33 14 33 15 
34 15 35 14 35 15 36 13 37 11 37 12
39 11 39 12 39 13 39 14 39 15 
40 11 40 13 40 15 41 11 41 13 41 15
42 11 42 15 43 11 43 15
45 11 45 12 45 13 45 14 45 15 
46 15 47 15 48 15 49 15 
52 11 52 12 52 13 52 15 
53 11 53 13 53 15  
54 11 54 13 54 15 
55 11 55 13 55 15 
56 11 56 13 56 15 
57 11 57 12 57 13 57 14 57 15
10 0
19 11 19 12 19 13 19 14 19 15
20 15 21 15 22 15 23 15 
25 11 25 12 25 13 25 14 25 15
26 11 26 13 26 15 27 11 27 13 27 15 
28 11 28 15 29 11 29 15 
31 11 31 12 32 13 33 14 33 15 
34 15 35 14 35 15 36 13 37 11 37 12
39 11 39 12 39 13 39 14 39 15 
40 11 40 13 40 15 41 11 41 13 41 15
42 11 42 15 43 11 43 15
45 11 45 12 45 13 45 14 45 15 
46 15 47 15 48 15 49 15 
52 11 52 12 52 13 53 13  
54 13 55 13 56 13 
57 11 57 12 57 13 57 14 57 15
11 0
19 11 19 12 19 13 19 14 19 15
20 15 21 15 22 15 23 15 
25 11 25 12 25 13 25 14 25 15
26 11 26 13 26 15 27 11 27 13 27 15 
28 11 28 15 29 11 29 15 
31 11 31 12 32 13 33 14 33 15 
34 15 35 14 35 15 36 13 37 11 37 12
39 11 39 12 39 13 39 14 39 15 
40 11 40 13 40 15 41 11 41 13 41 15
42 11 42 15 43 11 43 15
45 11 45 12 45 13 45 14 45 15 
46 15 47 15 48 15 49 15 
52 11 52 12 52 13 53 13  
54 13 55 13 56 13 
57 11 57 12 57 13 57 14 57 15
