1 0
31 8 31 9 31 10 31 11 31 12 31 13 31 14 31 15 31 16 31 17 31 18 
32 8 32 14 32 18
33 8 33 10 33 11 33 12 33 14 33 16 33 18 
34 8 34 10 34 12 34 16 34 18 
35 8 35 12 35 13 35 14 35 16 35 18
36 8 36 9 36 10 36 11 36 12 36 16 36 18
37 8 37 12 37 14 37 15 37 16 37 18
38 8 38 10 38 12 38 13 38 14 38 18
39 8 39 10 39 16 39 18
40 8 40 10 40 11 40 12 40 14 40 16 40 18
41 8 41 12 41 13 41 16 41 18
42 8 42 10 42 13 42 14 42 16 42 17 42 18
43 8 43 11 43 14 43 16 43 18
44 8 44 10 44 11 44 12 44 14 44 15 44 16 44 18
45 8 45 10 45 14 45 18
46 8 46 10 46 11 46 12 46 13 46 14 46 16 46 18
47 8 47 10 47 16 47 18
48 8 48 10 48 12 48 13 48 14 48 16 48 18
49 8 49 12 49 16
50 8 50 9 50 10 50 11 50 12 50 13 50 14 50 15 50 16 50 17 50 18 
2 0
20 3 20 4 20 5 20 6 20 7 20 8 20 9 20 10 20 11 20 12 20 13 20 14 20 15 20 16 20 17 20 18 20 19 20 20 20 21 20 22
21 3 21 5 21 9 21 13 21 22 22 3 22 5 22 7 22 9 22 11 22 13 22 15 22 16 22 17 22 18 22 19 22 20 22 22 
23 3 23 5 23 7 23 9 23 11 23 13 23 15 23 17 23 20 23 22
24 3 24 5 24 7 24 9 24 11 24 13 24 17 24 18 24 20 24 22
25 3 25 5 25 7 25 9 25 11 25 13 25 15 25 17 25 18 25 20 25 22
26 3 26 5 26 7 26 9 26 11 26 13 26 15 26 17 26 18 26 20 26 22
27 3 27 5 27 7 27 9 27 11 27 13 27 15 27 17 27 20 27 22
28 3 28 5 28 7 28 9 28 11 28 13 28 15 28 20 28 22 
29 3 29 5 29 7 29 9 29 11 29 13 29 15 29 17 29 19 29 20 29 22 
30 3 30 5 30 7 30 9 30 11 30 13 30 15 30 17 30 20 30 22
31 3 31 5 31 7 31 9 31 11 31 13 31 15 31 17 31 18 31 20 31 22
32 3 32 5 32 7 32 9 32 11 32 13 32 15 32 17 32 20 32 22 
33 3 33 5 33 7 33 9 33 11 33 13 33 15 33 17 33 18 33 20 33 22
34 3 34 5 34 7 34 9 34 11 34 13 34 15 34 17 34 20 34 22
35 3 35 5 35 7 35 9 35 11 35 13 35 15 35 17 35 18 35 20 35 22 
36 3 36 5 36 7 36 9 36 11 36 13 36 15 36 20 36 22 
37 3 37 5 37 7 37 9 37 11 37 13 37 15 37 17 37 19 37 22 
38 3 38 5 38 7 38 9 38 11 38 13 38 15 38 17 38 20 38 22
39 3 39 5 39 7 39 9 39 11 39 13 39 15 39 17 39 18 39 19 39 20 39 22 
40 3 40 5 40 7 40 9 40 11 40 13 40 15 40 17 40 20 40 22
41 3 41 5 41 7 41 9 41 11 41 13 41 15 41 17 41 19 41 20 41 21 41 22
42 3 42 5 42 7 42 9 42 11 42 13 42 15 42 17 42 20 42 22 
43 3 43 5 43 7 43 9 43 11 43 13 43 15 43 18 43 20 43 22
44 3 44 5 44 7 44 9 44 11 44 13 44 15 44 17 44 20 44 22 
45 3 45 5 45 7 45 9 45 11 45 13 45 15 45 17 45 18 45 22
46 3 46 5 46 7 46 9 46 11 46 13 46 15 46 17 46 20 46 22 
47 3 47 5 47 7 47 9 47 11 47 13 47 15 47 17 47 19 47 20 47 22 
48 3 48 5 48 7 48 9 48 11 48 13 48 15 48 17 48 20 48 22
49 3 49 5 49 7 49 9 49 11 49 13 49 15 49 17 49 18 49 20 49 22
50 3 50 5 50 7 50 9 50 11 50 13 50 15 50 20 50 22
51 3 51 5 51 7 51 9 51 11 51 13 51 15 51 16 51 17 51 18 51 19 51 20 51 22 
52 3 52 5 52 7 52 9 52 11 52 13 52 20 52 22 
53 3 53 5 53 7 53 9 53 11 53 13 53 15 53 16 53 17 53 20 53 22 
54 3 54 5 54 7 54 9 54 11 54 13 54 15 54 19 54 22
55 3 55 5 55 7 55 9 55 11 55 13 55 17 55 18 55 19 55 21 55 22 
56 3 56 5 56 7 56 9 56 11 56 13 56 15 56 17 56 22 
57 3 57 5 57 7 57 9 57 11 57 13 57 15 57 16 57 19 57 20 57 22
58 3 58 7 58 11 58 15 58 19 
59 3 59 4 59 5 59 6 59 7 59 8 59 9 59 10 59 11 59 12 59 13 59 14 59 15 59 16 59 17 59 18 59 19 59 20 59 21 59 22
3 0
31 5 31 6 31 7 31 8 31 9 31 10 31 11 31 12 31 13 31 14 31 15 31 16 31 17 31 18 31 19 31 20 31 21
32 5 32 9 32 15 32 21
33 5 33 7 33 9 33 11 33 12 33 13 33 15 33 17 33 18 33 19 33 21
34 5 34 6 34 7 34 9 34 13 34 15 34 19 34 21 
35 5 35 9 35 10 35 13 35 15 35 17 35 19 35 21
36 5 36 7 36 8 36 9 36 12 36 13 36 15 36 17 36 19 36 21
37 5 37 13 37 15 37 17 37 19 37 21
38 5 38 7 38 8 38 9 38 10 38 11 38 12 38 13 38 15 38 17 38 19 38 21
39 5 39 7 39 9 39 15 39 17 39 19 39 21
40 5 40 9 40 11 40 13 40 14 40 15 40 17 40 19 40 21
41 5 41 6 41 7 41 9 41 11 41 13 41 17 41 19 41 21 
42 5 42 7 42 9 42 11 42 12 42 13 42 14 42 15 42 16 42 17 42 19 42 21
43 5 43 9 43 19 43 21
44 5 44 7 44 8 44 9 44 10 44 11 44 12 44 13 44 14 44 15 44 16 44 17 44 18 44 19 44 20 44 21 
45 5 45 7 45 15 45 21
46 5 46 7 46 9 46 10 46 11 46 13 46 17 46 19 46 21
47 5 47 7 47 11 47 14 47 15 47 16 47 17 47 19 47 21
48 5 48 7 48 9 48 11 48 12 48 13 48 18 48 19 48 21
49 5 49 9 49 13 49 16 49 21
50 5 50 6 50 7 50 8 50 9 50 10 50 11 50 12 50 13 50 15 50 16 50 17 50 18 50 19 50 20 50 21
4 0
27 4 27 5 27 6 27 7 27 8 27 9 27 10 27 11 27 12 27 13 27 14 27 15 27 16 27 17 27 18 27 19 27 20 27 21 27 22
28 4 28 10 28 22
29 4 29 6 29 7 29 8 29 10 29 12 29 13 29 14 29 15 29 16 29 18 29 19 29 20 29 22
30 4 30 6 30 8 30 10 30 12 30 16 30 18 30 22
31 4 31 8 31 10 31 12 31 14 31 16 31 18 31 20 31 21 31 22
32 4 32 5 32 6 32 8 32 10 32 12 32 14 32 16 32 18 32 22
33 4 33 8 33 10 33 12 33 14 33 16 33 18 33 19 33 20 33 21 33 22
34 4 34 6 34 7 34 8 34 10 34 12 34 13 34 14 34 16 34 22
35 4 35 8 35 10 35 16 35 17 35 18 35 19 35 20 35 22
36 4 36 5 36 6 36 8 36 10 36 11 36 12 36 13 36 14 36 20 36 22
37 4 37 8 37 14 37 15 37 16 37 17 37 18 37 20 37 22
38 4 38 6 38 7 38 8 38 9 38 10 38 12 38 18 38 20 38 22
39 4 39 10 39 12 39 18 39 20 39 22
40 4 40 5 40 6 40 7 40 8 40 9 40 10 40 12 40 14 40 15 40 16 40 17 40 18 40 20 40 22
41 4 41 10 41 12 41 14 41 18 41 20 41 22
42 4 42 6 42 7 42 8 42 12 42 14 42 16 42 20 42 22
43 4 43 8 43 9 43 10 43 11 43 12 43 14 43 16 43 17 43 18 43 19 43 20 43 22
44 4 44 6 44 8 44 10 44 14 44 18 44 20 44 22
45 4 45 6 45 8 45 12 45 14 45 15 45 17 45 18 45 20 
46 4 46 6 46 8 46 10 46 11 46 12 46 15 46 17 46 18 46 20 46 21 46 22
47 4 47 6 47 14 47 17 47 18 47 20 47 22 
48 4 48 6 48 8 48 9 48 10 48 11 48 12 48 13 48 14 48 15 48 17 48 18 48 20 48 22
49 4 49 6 49 8 49 17 49 18 49 20 49 22
50 4 50 6 50 8 50 10 50 11 50 12 50 14 50 15 50 16 50 18 50 20 50 22
51 4 51 6 51 8 51 10 51 12 51 14 51 15 51 16 51 20 51 22
52 4 52 6 52 12 52 18 52 22
53 4 53 5 53 6 53 7 53 8 53 9 53 10 53 11 53 12 53 13 53 14 53 15 53 16 53 17 53 18 53 19 53 20 53 21 53 22
5 0
29 3 29 4 29 5 29 6 29 7 29 8 29 9 29 10 29 11 29 12 29 13 29 14 29 15 29 16 29 17 29 18 29 19 29 20 29 21 29 22 29 23
30 3 30 23 
31 3 31 5 31 6 31 7 31 8 31 9 31 10 31 12 31 13 31 14 31 15 31 16 31 17 31 19 31 20 31 21 31 22 31 23
32 3 32 14 32 22 32 23
33 3 33 4 33 5 33 6 33 8 33 9 33 10 33 11 33 12 33 13 33 14 33 15 33 16 33 17 33 19 33 20 33 21 33 22 33 23
34 3 34 11 34 19 34 23
35 3 35 5 35 6 35 7 35 8 35 9 35 10 35 11 35 12 35 13 35 14 35 16 35 17 35 18 35 19 35 20 35 21 35 23
36 3 36 11 36 19 36 23
37 3 37 5 37 6 37 7 37 8 37 9 37 11 37 12 37 14 37 15 37 16 37 17 37 18 37 19 37 20 37 21 37 22 37 23
38 3 38 8 38 12 38 23
39 3 39 4 39 5 39 6 39 8 39 9 39 11 39 12 39 13 39 15 39 16 39 17 39 18 39 19 39 21 39 22 39 23
40 3 40 12 40 19 40 23
41 3 41 5 41 6 41 7 41 8 41 9 41 10 41 11 41 12 41 13 41 14 41 15 41 16 41 18 41 19 41 20 41 21 41 22 41 23
42 3 42 16 42 23 
43 3 43 4 43 5 43 6 43 8 43 9 43 10 43 11 43 12 43 14 43 15 43 16 43 17 43 18 43 19 43 20 43 21 43 23
44 3 44 15 44 23
45 3 45 5 45 6 45 7 45 8 45 9 45 10 45 12 45 13 45 14 45 15 45 16 45 17 45 18 45 19 45 21 45 22 45 23
46 3 46 14 46 23
47 3 47 4 47 5 47 6 47 7 47 8 47 9 47 10 47 12 47 13 47 14 47 16 47 17 47 18 47 19 47 20 47 21 47 22 47 23
48 3 48 13 48 23
49 3 49 4 49 5 49 6 49 8 49 9 49 10 49 11 49 12 49 13 49 14 49 15 49 16 49 17 49 18 49 19 49 20 49 21 49 23
50 3 50 12 50 23
51 3 51 4 51 5 51 6 51 7 51 8 51 9 51 10 51 11 51 12 51 13 51 14 51 16 51 17 51 18 51 19 51 20 51 21 51 22 51 23 52 3 
53 3 53 4 53 5 53 6 53 7 53 8 53 9 53 10 53 11 53 12 53 13 53 14 53 15 53 16 53 17 53 18 53 19 53 20 53 21 53 22 53 23 
6 0
20 4 20 5 20 6
21 4 21 6 21 10 21 11 21 12 21 13 21 14 21 15 
22 4 22 6 22 10 22 11 22 12 22 13 22 14 22 15 
23 4 23 6 23 7 23 8 23 9 23 16 23 17 23 18 23 19 23 20 
24 4 24 11 24 12 24 13 24 14 24 19 24 21
25 4 25 6 25 7 25 8 25 9 25 10 25 15 25 16 25 17 25 19 25 21 
26 4 26 6 26 12 26 19 26 21
27 4 27 6 27 8 27 9 27 10 27 11 27 14 27 15 27 16 27 17 27 18 27 19 27 21
28 4 28 6 28 8 28 17 28 21
29 4 29 6 29 8 29 9 29 10 29 11 29 12 29 13 29 14 29 15 29 17 29 19 29 21
30 4 30 6 30 8 30 17 30 19 30 21
31 4 31 6 31 8 31 10 31 11 31 12 31 13 31 15 31 16 31 17 31 19 31 21
32 4 32 6 32 8 32 12 32 17 32 19 32 21
33 4 33 6 33 8 33 9 33 11 33 12 33 13 33 15 33 17 33 19 33 21
34 4 34 6 34 8 34 12 34 17 34 19 34 21
35 3 35 6 35 8 35 9 35 10 35 11 35 14 35 15 35 17 35 19 35 22
36 3 36 5 36 8 36 14 36 17 36 20 36 22
37 3 37 5 37 7 37 10 37 11 37 12 37 13 37 14 37 15 37 18 37 20 37 22 
38 3 38 5 38 7 38 14 38 18 38 20 38 22 
39 3 39 5 39 7 39 8 39 9 39 10 39 11 39 12 39 14 39 15 39 16 39 17 39 18 39 20 39 22
40 3 40 5 40 7 40 18 40 20 40 22 
41 3 41 5 41 7 41 9 41 10 41 11 41 12 41 13 41 14 41 15 41 16 41 17 41 18 41 20 41 22
42 3 42 5 42 7 42 18 42 20 42 22
43 3 43 5 43 7 43 8 43 9 43 10 43 12 43 13 43 14 43 15 43 16 43 18 43 20 43 22
44 3 44 5 44 7 44 12 44 18 44 20 44 22 
45 3 45 5 45 6 45 9 45 12 45 13 45 14 45 15 45 17 45 20 45 22 
46 3 46 6 46 8 46 10 46 11 46 17 46 19 46 22
47 4 47 6 47 8 47 17 47 19 47 21
48 4 48 6 48 8 48 9 48 11 48 12 48 13 48 14 48 15 48 17 48 19 48 21
49 4 49 6 49 8 49 17 49 19 49 21
50 4 50 6 50 8 50 10 50 11 50 12 50 13 50 14 50 16 50 17 50 19 50 21
51 4 51 6 51 8 51 17 51 19 51 21 
52 4 52 6 52 8 52 10 52 11 52 12 52 13 52 14 52 15 52 16 52 17 52 19 52 21 
53 4 53 6 53 8 53 17 53 19 53 21 
54 4 54 6 54 8 54 9 54 10 54 11 54 14 54 15 54 16 54 17 54 19 54 21 
55 4 55 6 55 12 55 13 55 19 55 21 
56 4 56 6 56 7 56 8 56 9 56 10 56 12 56 16 56 17 56 18 56 19 56 21
57 4 57 10 57 12 57 13 57 14 57 19 57 21 57 22 
58 5 58 6 58 7 58 8 58 9 58 16 58 17 58 18 58 19 
59 10 59 11 59 12 59 13 59 14 59 15 59 20 59 21 59 22
60 10 60 11 60 12 60 13 60 14 60 15 
7 0
20 3 20 4 20 5 20 6 20 7 20 8 20 9 20 10 20 11 20 12 20 13 20 14 20 15 20 16 20 17 20 18 20 19 20 20 20 21 20 22
21 3 21 22
22 3 22 4 22 5 22 10 22 11 22 16 22 17 22 22
23 3 23 7 23 8 23 10 23 13 23 14 23 16 23 18 23 19 23 20 23 22
24 3 24 5 24 6 24 10 24 14 24 16 24 22
25 3 25 5 25 6 25 7 25 8 25 9 25 10 25 11 25 13 25 14 25 15 25 16 25 17 25 18 25 19 25 20 25 22
26 3 26 16 26 22
27 3 27 4 27 5 27 7 27 8 27 10 27 11 27 13 27 14 27 16 27 17 27 19 27 20 27 22
28 3 28 14 28 18 28 22
29 3 29 5 29 6 29 7 29 8 29 9 29 11 29 12 29 13 29 14 29 15 29 16 29 18 29 19 29 20 29 21 29 22 
30 3 30 8 30 15 30 22
31 3 31 4 31 5 31 6 31 8 31 9 31 10 31 11 31 12 31 13 31 15 31 16 31 17 31 18 31 19 31 20 31 22
32 3 32 15 32 22
33 3 33 4 33 5 33 6 33 7 33 9 33 10 33 11 33 13 33 14 33 15 33 17 33 18 33 19 33 20 33 21 33 22
34 3 34 12 34 22
35 3 35 5 35 6 35 7 35 8 35 9 35 10 35 11 35 12 35 14 35 15 35 16 35 17 35 18 35 19 35 20 35 22
36 3 36 4 36 17 36 22
37 3 37 6 37 7 37 8 37 9 37 10 37 11 37 12 37 13 37 14 37 15 37 16 37 17 37 18 37 19 37 20 37 22
38 3 38 4 38 9 38 22
39 3 39 6 39 7 39 8 39 9 39 10 39 11 39 13 39 14 39 15 39 16 39 17 39 18 39 19 39 20 39 21 39 22
40 3 40 5 40 11 40 22
41 3 41 8 41 11 41 12 41 13 41 14 41 15 41 16 41 17 41 18 41 19 41 20 41 22
42 3 42 4 42 5 42 6 42 8 42 9 42 11 42 22
43 3 43 8 43 11 43 13 43 14 43 15 43 16 43 17 43 18 43 19 43 20 43 21 43 22
44 3 44 5 44 6 44 7 44 10 44 11 44 22
45 3 45 5 45 7 45 8 45 11 45 12 45 13 45 14 45 15 45 16 45 17 45 18 45 19 45 20 45 22
46 3 46 5 46 7 46 11 46 20 46 22
47 3 47 5 47 7 47 8 47 9 47 11 47 13 47 14 47 17 47 20 47 22
48 3 48 5 48 9 48 11 48 13 48 14 48 18 48 20 48 22
49 3 49 7 49 8 49 11 49 16 49 18 49 20 49 22
50 3 50 7 50 11 50 13 50 14 50 18 50 20 50 22 
51 3 51 4 51 5 51 7 51 9 51 10 51 11 51 13 51 14 51 17 51 20 51 22
52 3 52 7 52 11 52 20 52 22 
53 3 53 4 53 5 53 7 53 8 53 9 53 11 53 12 53 13 53 14 53 15 53 16 53 17 53 18 53 19 53 20 53 22
54 3 54 8 54 11 54 22
55 3 55 5 55 6 55 7 55 8 55 9 55 11 55 12 55 13 55 14 55 15 55 16 55 17 55 18 55 20 55 21 55 22
56 3 56 8 56 19 56 22
57 3 57 4 57 5 57 6 57 8 57 9 57 10 57 11 57 12 57 13 57 14 57 15 57 16 57 17 57 19 57 20 57 21 57 22 
58 3 58 16 
59 3 59 4 59 5 59 6 59 7 59 8 59 9 59 10 59 11 59 12 59 13 59 14 59 15 59 16 59 17 59 18 59 19 59 20 59 21 59 22






























